enemy_data=[[100,3,2,0,0,5,0,0,3
102,120,3,0,0,5,0,1,0
103,60,3,0,0,20,1,0,5
-26,5,2,0,1,3,0,0,0
-27,25,2,0,0,3,0,0,0
112,60,3,0,0,20,1,0,5]]