enemy_data=[[100,7,2,0,0,5,0,0,1
115,10,3,0,0,5,0,1,1:1
103,60,3,0,0,20,1,0,5
-26,5,2,0,1,3,0,0,0,1
-27,25,2,0,0,3,0,0,0
112,60,3,0,0,20,1,0,5
115,30,3,0,0,20,1,0,5]]